ACS_URL                                 string	https://karma.orange.com/krmx69/fr
username                                string	sagemcpetest
password                                string	catalina
ConnectionRequestPort                   unsignedInt	50805
IGD_Mngt_ConnectionRequestURLPath       string	/
ConnectionRequest_basic_auth_activate   boolean	0
ConnectionRequest_digest_auth_activate  boolean	1
ConnectionRequestBacklog                unsignedInt	100
ConnectionRequestUsername               string	Default
ConnectionRequestPassword               string	orange
authrealm                               string	gSOAP_Web_Service
id                                      string	LIVEBOX_ID_
send_http_opaque                        boolean 1
Maxenvelopes                            unsignedInt	1
receive_timeout                         unsignedInt	20
PeriodicInformInterval                  unsignedInt 432000
PeriodicInformTime                      unsignedInt	0
nbr_max_connection_request              unsignedInt 50
ConnectionRequestPeriod                 unsignedInt 3600
id_activate                             boolean	1
PeriodicInformEnable                    boolean	1
DownloadSleepDuration                   unsignedInt	25
autonome_mode                           boolean	0
with_certif_exchange                    boolean	1
client_pem                              string	/etc/client.pem
password_ssl                            string	NULL
cacert_pem                              string	/etc/cacert.pem
capath                                  string	NULL
ssl_randfile                            string	NULL
comm_mode                               unsignedInt	2
